"a" = (/turf/space,/area/space)
"c" = (/turf/simulated/wall/r_wall/prepainted,/area/mjolnir/outer)
"f" = (/obj/structure/grille,/turf/simulated/floor/tiled/monotile,/area/mjolnir/outer)
"g" = (/turf/space,/area/mjolnir/outer)
"j" = (/turf/simulated/floor/tiled/steel_ridged,/area/mjolnir/outer)
"r" = (/turf/simulated/floor/wood/walnut,/area/mjolnir/outer)
"v" = (/turf/simulated/floor/shuttle_ceiling,/area/mjolnir/outer)
"z" = (/turf/simulated/floor/tiled/steel_grid,/area/mjolnir/outer)
"A" = (/turf/unsimulated/wall,/area/mjolnir/outer)
"B" = (/turf/simulated/floor/wood/maple,/area/mjolnir/outer)
"C" = (/obj/structure/ladder/up,/turf/simulated/floor/tiled/steel_ridged,/area/mjolnir/outer)
"E" = (/turf/simulated/open,/area/mjolnir/outer)
"F" = (/obj/machinery/computer/shuttle_control/lift/robotics,/turf/simulated/floor/tiled/steel_grid,/area/mjolnir/outer)
"G" = (/obj/effect/landmark/map_data{height = 3},/turf/space,/area/space)
"H" = (/turf/simulated/floor/wood,/area/mjolnir/outer)
"I" = (/obj/effect/shuttle_landmark/lift/robotics_top,/turf/simulated/floor/tiled/steel_grid,/area/mjolnir/outer)
"J" = (/obj/structure/grille,/turf/simulated/floor/tiled/steel_ridged,/area/mjolnir/outer)
"L" = (/turf/simulated/floor/reinforced,/area/mjolnir/outer)
"N" = (/turf/simulated/floor/tiled,/area/mjolnir/outer)
"O" = (/turf/simulated/floor,/area/mjolnir/outer)
"T" = (/turf/simulated/floor/tiled/monotile,/area/mjolnir/outer)
"W" = (/turf/simulated/floor/grass,/area/mjolnir/outer)
"Y" = (/obj/structure/ladder/up,/turf/simulated/floor/tiled/monotile,/area/mjolnir/outer)

(1,1,1) = {"
aaaaaaaaaaaaaaaaaaaaaaaaaaaaaaaaaaaaaaaaaaaaaaaaaaaaaaaaaaaaaaaaaaaaaaaaaaaaaaaaaaaaaaaaaaaaaaaaaaaaaaaaaaaaaaaaaaaaaaaaaaaaaaaaaaaaaaaaaaaaaaaaaaaaaa
aaaaaaaaaaaaaaaaaaaaaaaaaaaaaaaaaaaaaaaaaaaaaaaaaaaaaaaaaaaaaaaaaaaaaaaaaaaaaaaaaaaaaaaaaaaaaaaaaaaaaaaaaaaaaaaaaaaaaaaaaaaaaaaaaaaaaaaaaaaaaaaaaaaaaa
aaAAAAAAAAAAAAAAAAAAAAAAAAAAAAAAAAAAAAAAAAAAAAAAAAAAAAAAAAAAAAAAAAAAAAAAAAAAAAAAAAAAAAAAAAAAAAAAAAAAAAAAAAAAAAAAAAAAAAAAAAAAAAAAAAAAAAAAAAAAAAAAAAAAaa
aaAggggggggggggggggggggggggggggggggggggggggggggggggggggggggggggggggggggggggggggggggggggggggggggggggggggggggggggggggggggggggggggggggggggggggggggggggAaa
aaAggggggggggggggggggggggggggggggggggggggggggggggggggggggggggggggggggggggggggggggggggggggggggggggggggggggggggggggggggggggggggggggggggggggggggggggggAaa
aaAggggggggggggggggggggggggggggggggggggggggggggggggggggggggggggggggggggggggggggggggggggggggggggggggggggggggggggggggggggggggggggggggggggggggggggggggAaa
aaAggggggggggggggggggggggggggggggggggggggggggggggggggggggggggggggggggggggggggggggggggggggggggggggggggggggggggggggggggggggggggggggggggggggggggggggggAaa
aaAggggggggggggggggggggggggggggggggggggggggggggggggggggggggggggggggggggggggggggggggggggggggggggggggggggggggggggggggggggggggggggggggggggggggggggggggAaa
aaAggggggggggggggggggggggggggggggggggggggggggggggggggggggggggggggggggggggggggggggggggggggggggggggggggggggggggggggggggggggggggggggggggggggggggggggggAaa
aaAggggggggggggggggggggggggggggggggggggggggggggggggggggggggggggggggggggggggggggggggggggggggggggggggggggggggggggggggggggggggggggggggggggggggggggggggAaa
aaAggggggggggggggggggggggggggggggggggggggggggggggggggggggggggggggggggggggggggggggggggggggggggggggggggggggggggggggggggggggggggggggggggggggggggggggggAaa
aaAggggggggggggggggggggggggggggggggggggggggggggggggggggggggggggggggggggggggggggggggggggggggggggggggggggggggggggggggggggggggggggggggggggggggggggggggAaa
aaAggggggggggggggggggggggggggggggggggggggggggggggggggggggggggggggggggggggggggggggggggggggggggggggggggggggggggggggggggggggggggggggggggggggggggggggggAaa
aaAggggggggggggggggggggggggggggggggggggggggggggggggggggggggggggggggggggggggggggggggggggggggggggggggggggggggggggggggggggggggggggggggggggggggggggggggAaa
aaAggggggggggggggggggggggggggggggggggggggggggggggggggggggggggggggggggggggggggggggggggggggggggggggggggggggggggggggggggggggggggggggggggggggggggggggggAaa
aaAgggggggggggLLLLLLLLLLLLLLLLggggggggggggggggggggggggggggggggggggggggggggggggggggggggggggggggggggLLLLLLLLLLLLLLLLLLLLLLLLLLLgggggggvvvvvvvvvvvggggAaa
aaAgggggggggggLLLLLLLLLLLLLLLLgggggggggggggggggggggggggggggggggggggggvvvvvvvvvvvvvggggggggggggggggLLLLLLLLLLLLLLLLLLLLLLLLLLLgggggggvvvvvvvvvvvggggAaa
aaAgggggggggggLLLLLLLLLLLLLLLLgggggggggggggggggggggggggggggggggggggggvvvvvvvvvvvvvggggggggggggggggLLLLLLLLLLLLLLLLLLLLLLLLLLLgggggggvvvvvvvvvvvggggAaa
aaAgggggggggggLLLLLLLLLLLLLLLLgggggggggggggggggggggggggggggggggggggggvvvvvvvvvvvvvggggvvvvvvvvvvggLLLLLLLLLLLLLLLLLLLLLLLLLLLgggggggvvvvvvvvvvvggggAaa
aaAgggggggggggLLLLLLLLLLLLLLLLLLLLLLLLLLLLgggggggggggggggggggggggggggvvvvvvvvvvvvvYgggvvvvvvvvvvggLLLLLLLLLLLLLLLLLLLLLLLLLLLgggggggvvvvvvvvvvvggggAaa
aaAgggggggggggLLLLLLLLLLLLLLLLLLLLLLLLLLLLggggggggvvvvvvvvvvvvvvvggggvvvvvvvvvvvvvggggvvvvvvvvvvggLLLLLLLLLLLLLLLLLLLLLLLLLLLgggggggvvvvvvvvvvvggggAaa
aaAgggggggggggLLLLLLLLLLLLLLLLLLLLLLLLLLLLggggggggvvvvvvvvvvvvvvvggggvvvvvvvvvvvvvggggvvvvvvvvvvggLLLLLLLLLLLLLLLLLLLLLLLLLLLgggggggvvvvvvvvvvvggggAaa
aaAgggggggggggLLLLLLLLLLLLLLLLLLLLLLLLLLLLggggggggvvvvvvvvvvvvvvvggggvvvvvvvvvvvvvggggvvvvvvvvvvggLLLLLLLLLLLLLLLLLLLLLLLLLLLgggggggvvvvvvvvvvvggggAaa
aaAgggggggggggLLLLLLLLLLLLLLLLLLLLLLLLLLLLggggggggvvvvvvvvvvvvvvvggggvvvvvvvvvvvvvggggvvvvvvvvvvggLLLLLLLLLLLLLLLLLLLLLLLLLLLgggggggvvvvvvvvvvvggggAaa
aaAgggggggggggLLLLLLLLLLLLLLLLLLLLLLLLLLLLggggggggvvvvvvvvvvvvvvvggvvvvvvvvvvvvvvvvvggvvvvvvvvvvggLLLLLLLLLLLLLLLLLLLLLLLLLLLgggggggvvvvvvvvvvvggggAaa
aaAgggggggggggLLLLLLLLLLLLLLLLLLLLLLLLLLLLggggggggvvvvvvvvvvvvvvvggvvvvvvvvvvvvvvvvvggvvvvvvvvvvggLLLLLLLLLLLLLLLLLLLLLLLLLLLgggggggvvvvvvvvvvvggggAaa
aaAgggggggggggLLLLLLLLLLLLLLLLLLLLLLLLLLLLggggggggvvvvvvvvvvvvvvvggvvvvvvvvvvvvvvvvvggvvvvvvvvvvggLLLLLLLLLLLLLLLLLLLLLLLLLLLgggggggvvvvvvvvvvvggggAaa
aaAgggggggggggLLLLLLLLLLLLLLLLLLLLLLLLLLLLggggggggvvvvvvvvvvvvvvvggvvvvvvvvvvvvvvvvvggggggggggggggggggggggggggLLLgggggggggggggggggggvvvvvvvvvvvggggAaa
aaAgggggggggggLLLLLLLLLLLLLLLLLLLLLLLLLLLLgggggggggggggggggggggggggvvvvvvvvvvvvvvvvvggggggggggggggggggggggggggggggggggggggggggggggggvvvvvvvvvvvggggAaa
aaAgggggggggggLLLLLLLLLLLLLLLLLLLLLLLLLLLLgggggggggggggggggggggggggvvvvvvvvvvvvvvvvvggggggggggggggggggggggggggggggggggggggggggggggggvvvvvvvvvvvggggAaa
aaAgggggggggggLLLLLLLLLLLLLLLLLLLLLLLLLLLLgggggggggggggggggggggggggvvvvvvvvvvvvvvvvvggggggggggggggggggggggggggggggggggggggggggggggggvvvvvvvvvvvggggAaa
aaAgggggggggggLLLLLLLLLLLLLLLLLLLLLLLLLLLLgggggggggggggggggggggggggvvvvvvvvvvvvvvvvvggggggggggggggggggggggggggggggggggggggggggggggggvvvvvvvvvvvggggAaa
aaAgggggggggggLLLLLLLLLLLLLLLLLLLLLLLLLLLLgggggggggggggggggggggggggvvvvvvvvvvvvvvvvvggggggggggggggggggggggggggggggggggggggggggggggggvvvvvvvvvvvggggAaa
aaAgggggggggggLLLLLLLLLLLLLLLLLLLLLLLLLLLLgggggggggggggggggggggggggvvvvvvvvvvvvvvvvvgggggggggggggggggggggggggggggggggggggggggggggggggggggggggggggggAaa
aaAgggggggggggLLLLLLLLLLLLLLLLLLLLLLLLLLLLgggggggggggggggggggggggggvvvvvvvvvvvvvvvvvgggggggggggggggggLLLggggggLLLggggggLLLgggggggggggggggggggggggggAaa
aaAgggggggggggLLLLLLLLLLLLLLLLLLLLLLLLLLLLgggggggggggggggggggggggggvvvvvvvvvvvvvvvvvgggggggggggggggggLLLLLLLLLLLLLLLLLLLLLLLgggggggggggggggggggggggAaa
aaAgggggggggggLLLLLLLLLLLLLLLLLLLLLLLLLLLLgggggggggggggggggggggggggvvvvvvvvvvvvvvvvvgggggggggggggggggLLLLLLLLLLLLLLLLLLLLLLLgggggggggggggggggggggggAaa
aaAgggggggggggLLLLLLLLLLLLLLLLLLLLLLLLLLLLgggggggggggggggggggggggggvvvvvvvvvvvvvvvvvgggggggggggggggggLLLLLLLLLLLLLLLLLLLLLLLgggggggggggggggggggggggAaa
aaAgggggggggggLLLLLLLLLLLLLLLLLLLLLLLLLLLLgggggggggggggggggggggggggggggggggggggggggggggggggggggggggggLLLLLLLLLLLLLLLLLLLLLLLgggggggggggggggggggggggAaa
aaAgggggggggggLLLLLLLLLLLLLLLLLLLLLLLLLLLLggggggggggggggggggggggggggggggggggggggggggggggggggggggggLLLLLLLLLLLLLLLLLLLLLLLLLLLggggggggggggggggggggggAaa
aaAgggggggggggLLLLLLLLLLLLLLLLLLLLLLLLLLLLgggggggggggggggggvvvvvvvvvgggvvvvvvvvvgggvvvvvvvvvvgggggLLLLLLLLLLLLLLLLLLLLLLLLLLLggggggggggggggggggggggAaa
aaAgggggggggggLLLLLLLLLLLLLLLLLLLLLLLLLLLLgggggggggggggggggvvvvvvvvvgggvvvvvvvvvgggvvvvvvvvvvgggggLLLLLLLLLLLLLLLLLLLLLLLLLLLggggggggggggggggggggggAaa
aaAgggggggggggLLLLLLLLLLLLLLLLLLLLLLLLLLLLgggggggggggggggggvvvvvvvvvgggvvvvvvvvvgggvvvvvvvvvvgggggLLLLLLLLLLLLLLLLLLLLLLLLLLLggggggggggggggggggggggAaa
aaAgggggggggggLLLLLLLLLLLLLLLLLLLLLLLLLLLLgggggggggggggggggvvvvvvvvvgggvvvvvvvvvgggvvvvvvvvvvgggggLLLLLLLLLLLLLLLLLLLLLLLLLLLggggggggggggggggggggggAaa
aaAgggggggggggLLLLLLLLLLLLLLLLLLLLLLLLLLLLgggggggggggggggggvvvvvvvvvgggvvvvvvvvvgggvvvvvvvvvvgggggLLLLLLLLLLLLLLLLLLLLLLLLLLLggggggggggggggggggggggAaa
aaAgggggggggggLLLLLLLLLLLLLLLLLLLLLLLLLLLLgggggggggggggggggvvvvvvvvvgggvvvvvvvvvgggvvvvvvvvvvgggggLLLLLLLLLLLLLLLLLLLLLLLLLLLggggggggggggggggggggggAaa
aaAgggggggggggLLLLLLLLLLLLLLLLLLLLLLLLLLLLgggggggggggggggggggggggggggggggggggggggggvvvvvvvvvvgggggLLLLLLLLLLLLLLLLLLLLLLLLLLLggggggggggggggggggggggAaa
aaAgggggggggggLLLLLLLLLLLLLLLLLLLLLLLLLLLLgggggggggggggggggggggggggggggggggggggggggvvvvvvvvvvgggggLLLLLLLLLLLLLLLLLLLLLLLLLLLggggggggggggggggggggggAaa
aaAggggggggggggggggggggggggggggggggggggggggggggggggggggggggggggggggggggggggggggggggvvvvvvvvvvgggggLLLLLLLLLLLLLLLLLLLLLLLLLLLggggggggggvvvvvgggggggAaa
aaAggggggggggggggggggggggggggggggggggggggggggggggggggggggggggggggggggggggggggggggggvvvvvvvvvvgggggLLLLLLLLLLLLLLjjjjCjjjjjjjJgggggggggvvvvvvvggggggAaa
aaAggggggggggggggggggggggggggggggggggggggggggggggggggggggggggggggggggggggggggggggggvvvvvvvvvvgggggLLLLLLLLLLLLLLjTTTTTTTTTTTfgggggggggvvvvvvvggggggAaa
aaAggggggggggggggggggLLLLLLLLLLLLgggggggggggggggggggggggggggggggggggggggggggggggggggggggggggggggggLLLLLLLLLLLLLLjLLLLLLLLLLLLgggggggggvvvvvvvggggggAaa
aaAggggggggggggggggggLLLLLLLLLLLLgggggggggggggggggggggggggggggggggggggggggggggggggggggggggggggggggLLLLLLLLLLLLLLjLLLLLLLLLLLLggggggggvvvvvvvvvgggggAaa
aaAggggggggggggggggggLLLLLLLLLLLLggggggggggggggggggggggggggggggggggggggggggggggggggggggggggggggggggggggggggggggggLLLLLLLLLLLLggggggvvvvvvvvvvvvvgggAaa
aaAggggggggggggggggggLLLLLLLLLLLLggggggggggggggggggggggggggggggggggggggggggggggggggggggggggggggggggggggggggggggggLLLLLLLLLLLLggggggvvvvvvvvvvvvvgggAaa
aaAggggggggggggggggggLLLLLLLLLLLLggggggggggggggggggggggggggggggggggggggggggggggggggggggggggggggggggggggggggggggggLLLLLLLLLLLLggggggvvvvvvvvvvvvvgggAaa
aaAggggggggggggggggggLLLLLLLLLLLLgggggggggggggggggggggggggvvvvvvvvgggggggggggggggggggggggggggggggggggggggggggggggLLLLLLLLLLLLggggggvvvvvvvvvvvvvgggAaa
aaAggggggggggggggggggLLLLLLLLLLLLgggggggggggggggggggggggggvvvvvvvvggggggggggggggggggggLLLLLLLggggggggggggggggggggLLLLLLLLLLLLggggggvvvvvvvvvvvvvgggAaa
aaAggggggggggggggggggLLLLLLLLLLLLgggggggggggggggggggggggggvvvvvvvvggggggggggggggggggggLLLLLLLggggggggggggggggggggLLLLLLLLLLLLggggggvvvvvvvvvvvvvgggAaa
aaAgggggvvvvvvvvvvvvgLLLLLLLLLLLLgggggggggggggggggggggggggvvvvvvvvggggggggggggggggggggLLLLLLLggggggggggggggggggggLLLLLLLLLLLLggggggvvvvvvvvvvvvvgggAaa
aaAgggggvvvvvvvvvvvvgLLLLLLLLLLLLgggggggggggggggggggggggggvvvvvvvvggggggggggggggggggggLLLLLLLggggggggggggggggggggLLLLLLLLLLLLggggggvvvvvvvvvvvvvgggAaa
aaAgggggvvvvvvvvvvvvgLLLLLLLLLLLLgggggggggggggggggggggggggvvvvvvvvggggggggggggggggggggLLLLLLLggggggggggggggggggggLLLLLLLLLLLLggggggvvvvvvvvvvvvvgggAaa
aaAgggggvvvvvvvvvvvvggggggggggggggggggggggggggggggggggggggvvvvvvvvggggggggggLLLLLLLLLLLLLLLLLLLLLggggggggggggggggggggggggggggggggggvvvvvvvvvvvvvgggAaa
aaAgggggvvvvvvvvvvvvggggggggggggggggggggggggggggggggggggggggggggggggggggggggLLLLLLLLLLLLLLLLLLLLLggggggggggggggggggggggggggggggggggvvvvvvvvvvvvvgggAaa
aaAgggggvvvvvvvvvvvvggggggggggggggggggggggggggggggggggggggggggggggggggggggggLLLLLLLLLLLLLLLLLLLLLggggggggggggggggggggggggggggggggggvvvvvvvvvvvvvgggAaa
aaAgggggvvvvvvvvvvvvggggggggggggggggggggggggggggggggggggggggggggggggggggggggLLLLLLLLLLLLLLLLLLLLLgggggggggggggggggggggggggggggggggggvvvvvvvvvvvggggAaa
aaAgggggvvvvvvvvvvvvggggggggggggggggggggggggggggggggggggggggggggggggggggggggLLLLLLLLLLLLLLLLLLLLLgggggggggggggggggggggggggggggggggggvvvvvvvvvvvggggAaa
aaAgggggvvvvvvvvvvvvggggggggggggggggggggggggggggggggggggggggggggggggggggggggLLLLLLLLLLLLLLLLLLLLLgggggggggggggggggggggggggggggggggggvvvvvvvvvvvggggAaa
aaAgggggvvvvvvvvvvvvggggggggggggggggggggggggggggggggggggggggggggggggggggggggLLLLLLLLLLLLLLLLLLLLLggggggggggggggggggggggggggggggggggggvvvvvvvvvgggggAaa
aaAgggggggggggggggggggggggggggggggggggggggggggggggggggggggggggggggggggggggggLLLLLLLLLLLLLLLLLLLLLggggggggggggggggggggggggggggggggggggggggggggggggggAaa
aaAgggggLLLLLLLLLLggggggggggLLLLLLcccccccccccccccgggggggggggggggggggggggggggLLLLLLLLLLLLLLLLLLLLLggggggggggggggggggggggggggggggggggggggggggggggggggAaa
aaAgggggLLLLLLLLLLggggggggggLLLLLLczFNNNcNNNNNNNcgggggggggggggggggggggggggggLLLLLLLLLLLLLLLLLLLLLggggggggggggggggggggggggggggggggggggggggggggggggggAaa
aaAgggggLLLLLLLLLLLLLLLLLLLLLLLLLLczzNNNcNNNNNNNcgggggggggggggggggggggggggggLLLLLLLLLLLLLLLLLLLLLggggggggggggggggggggggggggggggggggggggggggggggggggAaa
aaAgggggLLLLLLLLLLLLLLLLLLLLLLLLLLcIzNNNcNNNNNNNcgggggggggggggggvvvvvvvvvvggLLLLLLLLLLLLLLLLLLLLLggggggggggggggggggggggggggggggggggggggggggggggggggAaa
aaAgggggLLLLLLLLLLLLLLLLLLLLLLLLLLcNNNNNcNNNNNNNcgggggggggggggggvvvvvvvvvvgggggggOgggggggggggggggggggggggggggggggggggggggggggggggggggggggggggggggggAaa
aaAgggggLLLLLLLLLLLLLLLLLLLLLLLLLLcccNcccNNNNNNNcgggggggggggggggvvvvvvvvvvggggggOOOggggggggggggggggggggggggggggggggggggggggggggggggggggggggggggggggAaa
aaAgggggLLLLLLLLLLLLLLLLLLLLLLLLLLcNNNNNcNNNNNNNcgggggggggggggggvvvvvvvvvvgOOOOOOOOOOOOOOOOOOOOOOOgggggggggggggggggggggggggggggggggggggggggggggggggAaa
aaAgggggLLLLLLLLLLLLLLLLLLLLLLLLLLcNNNNNcNNNNNNNcgggggggggggggggvvvvvvvvvvOOOOOOOOOOOOOOOOOOOOOOOOgggggggggggggggggggggggggggggggggggggggggggggggggAaa
aaAgggggLLLLLLLLLLLLLLLLLLLLLLLLLLcNNNNNcNNNNNNNcgggggggggggggggvvvvvvvvvvgOOOOOOOOOOOOOOOOOOOOOOOgggggggggggggggggggggggggggggggggggggggggggggggggAaa
aaAgggggLLLLLLLLLLLLLLLLLLLLLLLLLLcNNNNNNNNNNNNNcgggggggggggggggvvvvvvvvvvggggggOOOggggggggggggggggggggggggggggggggggggggggggggggggggggggggggggggggAaa
aaAgggggLLLLLLLLLLLLLLLLLLLLLLLLLLcNNNNNNNNNNNNNcgggggggggggggggvvvvvvvvvvgggggggOgggggggggggggggggggggggggggggggggggggggggggggggggggggggggggggggggAaa
aaAgggggLLLLLLLLLLLLLLLLLLLLLLLLLLcEENNNcNNNNNNNcgggggggggggggggvvvvvvvvvvggLLLLLLLLLLLLLLLLgggvvvvvvvvvgggggggggggggggggggggggggggggggggggggggggggAaa
aaAgggggLLLLLLLLLLLLLLLLLLLLLLLLLLcEENNNcNNNNNNNcgggggggggggggggggggggggggggLLLLLLLLLLLLLLLLgggvvvvvvvvvgggggggggggggggggggggggggggggggggggggggggggAaa
aaAgggggLLLLLLLLLLggggggggggLLLLLLcNNNNNcNNNNNNNcgggggggggggggggggggggggggggLLLLLLLLLLLLLLLLgggvvvvvvvvvgggggggggggggggggggggggggggggggggggggggggggAaa
aaAgggggLLLLLLLLLLggggggggggLLLLLLcccccccccccccccgggggggHHHHHHHHgggHHHHHHHggLLLLLLLLLLLLLLLLOOOvvvvvvvvvgggggggggggggggggggggggggggggggggggggggggggAaa
aaAgggggggggggggggggggggggggggggggggggggggggggggggggggggHHHHHHHHgggHHHHHHHggLLLLLLLLLLLLLLLLOOOvvvvvvvvvgggggggggggggggggggggggggggggggggggggggggggAaa
aaAgggggggggggggggggggggggggggggggggggggggggggggggggggggHHHHHHHHgggHHHHHHHggLLLLLLLLLLLLLLLLOOOvvvvvvvvvgggggggggggggggggggggggggggggggggggggggggggAaa
aaAgggggggggggggggggggggggggggggggggggggggggggggggggggggHHHHHHHHgggHHHHHHHggLLLLLLLLLLLLLLLLgggvvvvvvvvvgggggggggggggggggggggggggggggggggggggggggggAaa
aaAggggggggggggggggggLLLLLLLLLLLLWWHHHHHHHHHHHHHHgggggggHHHHHHHHgggHHHHHHHggLLLLLLLLLLLLLLLLgggvvvvvvvvvgggggggggLLLLLLLLLLLLggggggggggggggggggggggAaa
aaAggggggggggggggggggLLLLLLLLLLLLWWHHHHHHHHHHHHHHgggggggHHHHHHHHgggHHHHHHHggLLLLLLLLLLLLLLLLgggvvvvvvvvvgggggggggLLLLLLLLLLLLggggggggggggggggggggggAaa
aaAggggggggggggggggggLLLLLLLLLLLLWWHHHHHHHHHHHHHHgggggggHHHHHHHHgggHHHHHHHggLLLLLLLLLLLLLLLLgggggggggggggggggggggLLLLLLLLLLLLggggggggggggggggggggggAaa
aaAggggggggggggggggggLLLLLLLLLLLLWWHHHHHHHHHHHHHHgggggggHHHHHHHHgggHHHHHHHggggggggggLLLLLLLLgggggggggggggggggggggLLLLLLLLLLLLggggggggggggggggggggggAaa
aaAggggggggggggggggggLLLLLLLLLLLLWWHHHHHHHHHHHHHHgggggggHHHHHHHHgggHHHHHHHggggggggggLLLLLLLLgggggggggggggggggggggLLLLLLLLLLLLggggggggggggggggggggggAaa
aaAggggggggggggggggggLLLLLLLLLLLLWWHHHHHHHHHHHHHHgggggggggggggggggggggggggggggggggggLLLLLLLLgggggggggggggggggggggLLLLLLLLLLLLggggggggggggggggggggggAaa
aaAggggggggggggggggggLLLLLLLLLLLLWWHHHHHHHHHHHHHHgggggggggggggggggggggggggggggggggggLLLLLLLLgggggggggggggggggggggLLLLLLLLLLLLggggggggggggggggggggggAaa
aaAggggggggggggggggggLLLLLLLLLLLLWWHHHHHHHHHHHHHHgggggggBBBBBBggggggggggggggggggggggLLLLLLLLgggggggggggggggggggggLLLLLLLLLLLLggggggggggggggggggggggAaa
aaAggggggggggggggggggLLLLLLLLLLLLWWHHHHHHHHHHHHHHgggggggBBBBBBggggggggggggggggggggggLLLLLLLLgggggggggggggggggggggLLLLLLLLLLLLggggggggggggggggggggggAaa
aaAggggggggggggggggggLLLLLLLLLLLLWWHHHHHHHHHHHHHHgggggggBBBBBBggggggggggggggggggggggLLLLLLLLgggggggggggggggggggggLLLLLLLLLLLLggggggggggggggggggggggAaa
aaAggggggggggggggggggLLLLLLLLLLLLWWHHHHHHHHHHHHHHgggggggBBBBBBgggggggggggggggggggggggggggggggggggggggggggggggggggLLLLLLLLLLLLggggggggggggggggggggggAaa
aaAgggggggggggggggggggggggggggggggggggggggggggggggggggggBBBBBBgggggggggggggggggggggggggggggggggggggggggggggggggggggggggggggggggggggggggggggggggggggAaa
aaAggggggggggggggggggggggggggggggggggggggggggggggggggggggggggggggggggggggggggggggggggggggggggggggggggggggggggggggggggggggggggggggggggggggggggggggggAaa
aaAgggggggggggggggggggggggggggggggggggggggggggggggggggggBBBBBBgggggggggggggggggggggggggggggggggggggggggggggggggggggggggggggggggggggggggggggggggggggAaa
aaAgggggggggggggggggggggggggggggggggggggggggggggggggggggBBBBBBgggggggggggggggggggggggggggggggggggggggggggggggggggggggggggggggggggggggggggggggggggggAaa
aaAgggggggggggggggggggggggggggggggggggggggggggggggggggggBBBBBBgggggggggggggggggggggggggggggggggggggggggggggggggggggggggggggggggggggggggggggggggggggAaa
aaAgggggggggggggggggggggggggggggggggggggggggggggggggggggBBBBBBgggggggggggggggggggggggggggggggggggggggggggggggggggggggggggggggggggggggggggggggggggggAaa
aaAgggggggggggggggggggggggggggggggggggggggggggggggggggggBBBBBBgggggggggggggggggggggggggggggggggggggggggggggggggggggggggggggggggggggggggggggggggggggAaa
aaAggggggggggggggggggggggggggggggggggggggggggggggggggggggggggggggggggggggggggggggggggggggggggggggggggggLLLLLLLLLLLLLLLLLLLLLLLLLLLLLLLLLLLLLLLLLLLgAaa
aaAgggggggggggggggggggrrrrrrrrrrrrrrrrrrrgggggggggggggggBBBBBBggggggggggggggggggggggggggggggggggggggggLLLLLLLLLLLLLLLLLLLLLLLLLLLLLLLLLLLLLLLLLLLLgAaa
aaAgggggggggggggggggggrrrrrrrrrrrrrrrrrrrgggggggggggggggBBBBBBgggggggggggggggggggggggggggggggggggggggLLLLLLLLLLLLLLLLLLLLLLLLLLLLLLLLLLLLLLLLLLLLLgAaa
aaAgggggggggggggggggggrrrrrrrrrrrrrrrrrrrgggggggggggggggBBBBBBggggggggggggggggggggggggLLLLLLLLLLLLLLLLLLLLLLLLLLLLLLLLLLLLLLLLLLLLLLLLLLLLLLLLLLLLgAaa
aaAgggggggggggggggggggrrrrrrrrrrrrrrrrrrrgggggggggggggggBBBBBBggggggggggggggggggggggggLLLLLLLLLLLLLLLLLLLLLLLLLLLLLLLLLLLLLLLLLLLLLLLLLLLLLLLLLLLLgAaa
aaAgggggggggggggggggggrrrrrrrrrrrrrrrrrrrgggggggggggggggBBBBBBggggggggggggggggggggggggLLLLLLLLLLLLLLLLLLLLLLLLLLLLLLLLLLLLLLLLLLLLLLLLLLLLLLLLLLLLgAaa
aaAgggggggggggggggggggrrrrrrrrrrrrrrrrrrrgggggggggggggggggggggggLLLLLLLLLLggggggggggggLLLLLLLLLLLLLLLLLLLLLLLLLLLLLLLLLLLLLLLLLLLLLLLLLLLLLLLLLLLLgAaa
aaAgggggggggggggggggggrrrrrrrrrrrrrrrrrrrgggggggggggggggggggggggLLLLLLLLLLggggggggggggLLLLLLLLLLLLLLLLLLLLLLLLLLLLLLLLLLLLLLLLLLLLLLLLLLLLLLLLLLLLgAaa
aaAgggggggggggggggggggrrrrrrrrrrrrrrrrrrrgggggggggggggggggggggggLLLLLLLLLLggggggggggggLLLLLLLLLLLLLLLLLLLLLLLLLLLLLLLLLLLLLLLLLLLLLLLLLLLLLLLLLLLLgAaa
aaAgggggggggggggggggggrrrrrrrrrrrrrrrrrrrgggggggggggggggggggggggLLLLLLLLLLggggggggggggLLLLLLLLLLLLLLLLLLLLLLLLLLLLLLLLLLLLLLLLLLLLLLLLLLLLLLLLLLLLgAaa
aaAgggggggggggggggggggrrrrrrrrrrrrrrrrrrrgggggggggggggggggggggggLLLLLLLLLLggggggggggggLLLLLLLLLLLLLLLLLLLLLLLLLLLLLLLLLLLLLLLLLLLLLLLLLLLLLLLLLLLLgAaa
aaAgggggggggggggggggggrrrrrrrrrrrrrrrrrrrgggggggggggggggggggggggLLLLLLLLLLggggggggggggLLLLLLLLLLLLLLLLLLLLLLLLLLLLLLLLLLLLLLLLLLLLLLLLLLLLLLLLLLLLgAaa
aaAgggggggggggggggggggrrrrrrrrrrrrrrrrrrrgggggggggggggggggggggggLLLLLLLLLLggggggggggggLLLLLLLLLLLLLLLLLLLLLLLLLLLLLLLLLLLLLLLLLLLLLLLLLLLLLLLLLLLLgAaa
aaAgggggggggggggggggggrrrrrrrrrrrrrrrrrrrgggggggggggggggggggggggLLLLLLLLLLggggggggggggLLLLLLLLLLLLLLLLLLLLLLLLLLLLLLLLLLLLLLLLLLLLLLLLLLLLLLLLLLLLgAaa
aaAgggggggggggggggggggggggggggggggggggggggggggggggggggggggggggggLLLLLLLLLLggggggggggggLLLLLLLLLLLLLLLLLLLLLLLLLLLLLLLLLLLLLLLLLLLLLLLLLLLLLLLLLLLLgAaa
aaAggggggggggggggggggggggggggggggHHHHHHHHgggggggggggggggggggggggLLLLLLLLLLggggggggggggLLLLLLLLLLLLLLLLLLLLLLLLLLLLLLLLLLLLLLLLLLLLLLLLLLLLLLLLLLLLgAaa
aaAggggggggggggggggggggggggggggggHHHHHHHHgggggggggggggggggggggggLLLLLLLLLLggggggggggggLLLLLLLLLLLLLLLLLLLLLLLLLLLLLLLLLLLLLLLLLLLLLLLLLLLLLLLLLLLLgAaa
aaAggggggggggggggggggggggggggggggHHHHHHHHgggggggggggggggggggggggggggggggggggggggggggggLLLLLLLLLLLLLLLLLLLLLLLLLLLLLLLLLLLLLLLLLLLLLLLLLLLLLLLLLLLLgAaa
aaAggggggggggggggggggggggggggggggHHHHHHHHgggggggggggggggggggggggggggggggggggggggggggggLLLLLLLLLLLLLLLLLLLLLLLLLLLLLLLLLLLLLLLLLLLLLLLLLLLLLLLLLLLLgAaa
aaAggggggggggggggggggggggggggggggHHHHHHHHHHHHHHgggggggggggggggggggggggggggggggggggggggLLLLLLLLLLLLLLLLLLLLLLLLLLLLLLLLLLLLLLLLLLLLLLLLLLLLLLLLLLLLgAaa
aaAggggggggggggggggggggggggggggggHHHHHHHHHHHHHHggLLLLLLLLLggggggLLLLLLLLLgggggggggggggLLLLLLLLLLLLLLLLLLLLLLLLLLLLLLLLLLLLLLLLLLLLLLLLLLLLLLLLLLLLgAaa
aaAggggggggggggggggggggggggggggggHHHHHHHHHHHHHHggLLLLLLLLLggggggLLLLLLLLLgggggggggggggLLLLLLLLLLLLLLLLLLLLLLLLLLLLLLLLLLLLLLLLLLLLLLLLLLLLLLLLLLLLgAaa
aaAggggggggggggggggggggggggggggggHHHHHHHHHHHHHHggLLLLLLLLLggggggLLLLLLLLLgggggggggggggLLLLLLLLLLLLLLLLLLLLLLLLLLLLLLLLLLLLLLLLLLLLLLLLLLLLLLLLLLLLgAaa
aaAggggggggggggggggggggggggggggggHHHHHHHHHHHHHHggLLLLLLLLLggggggLLLLLLLLLgggggggggggggLLLLLLLLLLLLLLLLLLLLLLLLLLLLLLLLLLLLLLLLLLLLLLLLLLLLLLLLLLLLgAaa
aaAggggggggggggggggggggggggggggggHHHHHHHHHHHHHHggLLLLLLLLLggggggLLLLLLLLLgggggggggggggLLLLLLLLLLLLLLLLLLLLLLLLLLLLLLLLLLLLLLLLLLLLLLLLLLLLLLLLLLLLgAaa
aaAggggggggggggggggggggggggggggggggggggggggggggggLLLLLLLLLggggggLLLLLLLLLgggggggggggggLLLLLLLLLLLLLLLLLLLLLLLLLLLLLLLLLLLLLLLLLLLLLLLLLLLLLLLLLLLLgAaa
aaAggggggggggggggggggggggggggggggggggggggggggggggLLLLLLLLLggggggLLLLLLLLLgggggggggggggLLLLLLLLLLLLLLLLLLLLLLLLLLLLLLLLLLLLLLLLLLLLLLLLLLLLLLLLLLLLgAaa
aaAggggggggggggggggggggggggggggggggggggggggggggggLLLLLLLLLggggggLLLLLLLLLgggggggggggggLLLLLLLLLLLLLLLLLLLLLLLLLLLLLLLLLLLLLLLLLLLLLLLLLLLLLLLLLLLLgAaa
aaAggggggggggggggggggggggggggggggggggggggggggggggLLLLLLLLLggggggLLLLLLLLLgggggggggggggLLLLLLLLLLLLLLLLLLLLLLLLLLLLLLLLLLLLLLLLLLLLLLLLLLLLLLLLLLLLgAaa
aaAggggggggggggggggggggggggggggggggggggggggggggggLLLLLLLLLggggggLLLLLLLLLgggggggggggggLLLLLLLLLLLLLLLLLLLLLLLLLLLLLLLLLLLLLLLLLLLLLLLLLLLLLLLLLLLLgAaa
aaAgggggggggggggggggggggggggggggggggggggggggggggggggggggggggggggggggggggggggggggggggggLLLLLLLLLLLLLLLLLLLLLLLLLLLLLLLLLLLLLLLLLLLLLLLLLLLLLLLLLLLLgAaa
aaAgggggggggggggggggggggggggggggggggggggggggggggggggggggggggggggggggggggggggggggggggggLLLLLLLLLLLLLLLLLLLLLLLLLLLLLLLLLLLLLLLLLLLLLLLLLLLLLLLLLLLLgAaa
aaAgggggggggggggggggggggggggggggggggggggggggggggggggggggggggggggggggggggggggggggggggggLLLLLLLLLLLLLLLLLLLLLLLLLLLLLLLLLLLLLLLLLLLLLLLLLLLLLLLLLLLLgAaa
aaAgggggggggggggggggggggggggggggggggggggggggggggggggggggggggggggggggggggggggggggggggggLLLLLLLLLLLLLLLLLLLLLLLLLLLLLLLLLLLLLLLLLLLLLLLLLLLLLLLLLLLLgAaa
aaAgggggggggggggggggggggggggggggggggggggggggggggggggggggggggggggggggggggggggggggggggggLLLLLLLLLLLLLLLLLLLLLLLLLLLLLLLLLLLLLLLLLLLLLLLLLLLLLLLLLLLLgAaa
aaAggggggggggggggggggggggggggggggggggggggggggggggggggggggggggggggggggggggggggggggggggggggggggggggggggggggggggggggggggggggggggggggggggggggggggggggggAaa
aaAggggggggggggggggggggggggggggggggggggggggggggggggggggggggggggggggggggggggggggggggggggggggggggggggggggggggggggggggggggggggggggggggggggggggggggggggAaa
aaAggggggggggggggggggggggggggggggggggggggggggggggggggggggggggggggggggggggggggggggggggggggggggggggggggggggggggggggggggggggggggggggggggggggggggggggggAaa
aaAggggggggggggggggggggggggggggggggggggggggggggggggggggggggggggggggggggggggggggggggggggggggggggggggggggggggggggggggggggggggggggggggggggggggggggggggAaa
aaAggggggggggggggggggggggggggggggggggggggggggggggggggggggggggggggggggggggggggggggggggggggggggggggggggggggggggggggggggggggggggggggggggggggggggggggggAaa
aaAggggggggggggggggggggggggggggggggggggggggggggggggggggggggggggggggggggggggggggggggggggggggggggggggggggggggggggggggggggggggggggggggggggggggggggggggAaa
aaAAAAAAAAAAAAAAAAAAAAAAAAAAAAAAAAAAAAAAAAAAAAAAAAAAAAAAAAAAAAAAAAAAAAAAAAAAAAAAAAAAAAAAAAAAAAAAAAAAAAAAAAAAAAAAAAAAAAAAAAAAAAAAAAAAAAAAAAAAAAAAAAAAaa
aaaaaaaaaaaaaaaaaaaaaaaaaaaaaaaaaaaaaaaaaaaaaaaaaaaaaaaaaaaaaaaaaaaaaaaaaaaaaaaaaaaaaaaaaaaaaaaaaaaaaaaaaaaaaaaaaaaaaaaaaaaaaaaaaaaaaaaaaaaaaaaaaaaaaa
Gaaaaaaaaaaaaaaaaaaaaaaaaaaaaaaaaaaaaaaaaaaaaaaaaaaaaaaaaaaaaaaaaaaaaaaaaaaaaaaaaaaaaaaaaaaaaaaaaaaaaaaaaaaaaaaaaaaaaaaaaaaaaaaaaaaaaaaaaaaaaaaaaaaaaa
"}
