"a" = (/turf/space,/area/space)
"c" = (/turf/simulated/wall/r_wall/prepainted,/area/mjolnir/outer)
"g" = (/turf/space,/area/mjolnir/outer)
"j" = (/turf/simulated/wall/r_wall/prepainted,/area/mjolnir/com)
"r" = (/turf/simulated/floor/wood/walnut,/area/mjolnir/outer)
"v" = (/turf/simulated/floor/shuttle_ceiling,/area/mjolnir/outer)
"z" = (/turf/simulated/floor/tiled/steel_grid,/area/mjolnir/outer)
"A" = (/turf/unsimulated/wall,/area/mjolnir/outer)
"B" = (/turf/simulated/floor/wood/maple,/area/mjolnir/outer)
"C" = (/obj/structure/ladder/up,/turf/simulated/floor/tiled/steel_ridged,/area/mjolnir/outer)
"E" = (/turf/simulated/open,/area/mjolnir/outer)
"F" = (/obj/machinery/computer/shuttle_control/lift/robotics,/turf/simulated/floor/tiled/steel_grid,/area/mjolnir/outer)
"G" = (/obj/effect/landmark/map_data{height = 3},/turf/space,/area/space)
"H" = (/turf/simulated/floor/wood,/area/mjolnir/outer)
"I" = (/obj/effect/shuttle_landmark/lift/robotics_top,/turf/simulated/floor/tiled/steel_grid,/area/mjolnir/outer)
"J" = (/turf/simulated/floor/tiled,/area/mjolnir/com)
"L" = (/turf/simulated/floor/reinforced,/area/mjolnir/outer)
"N" = (/turf/simulated/floor/tiled,/area/mjolnir/outer)
"O" = (/turf/simulated/open,/area/mjolnir/com)
"W" = (/turf/simulated/floor/lino,/area/mjolnir/com)
"Y" = (/obj/structure/ladder/up,/turf/simulated/floor/tiled/monotile,/area/mjolnir/outer)

(1,1,1) = {"
aaaaaaaaaaaaaaaaaaaaaaaaaaaaaaaaaaaaaaaaaaaaaaaaaaaaaaaaaaaaaaaaaaaaaaaaaaaaaaaaaaaaaaaaaaaaaaaaaaaaaaaaaaaaaaaaaaaaaaaaaaaaaaaaaaaaaaaaaaaaaaaaaaaaaa
aaaaaaaaaaaaaaaaaaaaaaaaaaaaaaaaaaaaaaaaaaaaaaaaaaaaaaaaaaaaaaaaaaaaaaaaaaaaaaaaaaaaaaaaaaaaaaaaaaaaaaaaaaaaaaaaaaaaaaaaaaaaaaaaaaaaaaaaaaaaaaaaaaaaaa
aaAAAAAAAAAAAAAAAAAAAAAAAAAAAAAAAAAAAAAAAAAAAAAAAAAAAAAAAAAAAAAAAAAAAAAAAAAAAAAAAAAAAAAAAAAAAAAAAAAAAAAAAAAAAAAAAAAAAAAAAAAAAAAAAAAAAAAAAAAAAAAAAAAAaa
aaAggggggggggggggggggggggggggggggggggggggggggggggggggggggggggggggggggggggggggggggggggggggggggggggggggggggggggggggggggggggggggggggggggggggggggggggggAaa
aaAggggggggggggggggggggggggggggggggggggggggggggggggggggggggggggggggggggggggggggggggggggggggggggggggggggggggggggggggggggggggggggggggggggggggggggggggAaa
aaAggggggggggggggggggggggggggggggggggggggggggggggggggggggggggggggggggggggggggggggggggggggggggggggggggggggggggggggggggggggggggggggggggggggggggggggggAaa
aaAggggggggggggggggggggggggggggggggggggggggggggggggggggggggggggggggggggggggggggggggggggggggggggggggggggggggggggggggggggggggggggggggggggggggggggggggAaa
aaAggggggggggggggggggggggggggggggggggggggggggggggggggggggggggggggggggggggggggggggggggggggggggggggggggggggggggggggggggggggggggggggggggggggggggggggggAaa
aaAggggggggggggggggggggggggggggggggggggggggggggggggggggggggggggggggggggggggggggggggggggggggggggggggggggggggggggggggggggggggggggggggggggggggggggggggAaa
aaAggggggggggggggggggggggggggggggggggggggggggggggggggggggggggggggggggggggggggggggggggggggggggggggggggggggggggggggggggggggggggggggggggggggggggggggggAaa
aaAggggggggggggggggggggggggggggggggggggggggggggggggggggggggggggggggggggggggggggggggggggggggggggggggggggggggggggggggggggggggggggggggggggggggggggggggAaa
aaAggggggggggggggggggggggggggggggggggggggggggggggggggggggggggggggggggggggggggggggggggggggggggggggggggggggggggggggggggggggggggggggggggggggggggggggggAaa
aaAggggggggggggggggggggggggggggggggggggggggggggggggggggggggggggggggggggggggggggggggggggggggggggggggggggggggggggggggggggggggggggggggggggggggggggggggAaa
aaAggggggggggggggggggggggggggggggggggggggggggggggggggggggggggggggggggggggggggggggggggggggggggggggggggggggggggggggggggggggggggggggggggggggggggggggggAaa
aaAggggggggggggggggggggggggggggggggggggggggggggggggggggggggggggggggggggggggggggggggggggggggggggggggggggggggggggggggggggggggggggggggggggggggggggggggAaa
aaAgggggggggggLLLLLLLLLLLLLLLLggggggggggggggggggggggggggggggggggggggggggggggggggggggggggggggggggggLLLLLLLLLLLLLLLLLLLLLLLLLLLgggggggvvvvvvvvvvvggggAaa
aaAgggggggggggLLLLLLLLLLLLLLLLgggggggggggggggggggggggggggggggggggggggvvvvvvvvvvvvvggggggggggggggggLLLLLLLLLLLLLLLLLLLLLLLLLLLgggggggvvvvvvvvvvvggggAaa
aaAgggggggggggLLLLLLLLLLLLLLLLgggggggggggggggggggggggggggggggggggggggvvvvvvvvvvvvvggggggggggggggggLLLLLLLLLLLLLLLLLLLLLLLLLLLgggggggvvvvvvvvvvvggggAaa
aaAgggggggggggLLLLLLLLLLLLLLLLgggggggggggggggggggggggggggggggggggggggvvvvvvvvvvvvvggggvvvvvvvvvvggLLLLLLLLLLLLLLLLLLLLLLLLLLLgggggggvvvvvvvvvvvggggAaa
aaAgggggggggggLLLLLLLLLLLLLLLLLLLLLLLLLLLLgggggggggggggggggggggggggggvvvvvvvvvvvvvYgggvvvvvvvvvvggLLLLLLLLLLLLLLLLLLLLLLLLLLLgggggggvvvvvvvvvvvggggAaa
aaAgggggggggggLLLLLLLLLLLLLLLLLLLLLLLLLLLLggggggggvvvvvvvvvvvvvvvggggvvvvvvvvvvvvvggggvvvvvvvvvvggLLLLLLLLLLLLLLLLLLLLLLLLLLLgggggggvvvvvvvvvvvggggAaa
aaAgggggggggggLLLLLLLLLLLLLLLLLLLLLLLLLLLLggggggggvvvvvvvvvvvvvvvggggvvvvvvvvvvvvvggggvvvvvvvvvvggLLLLLLLLLLLLLLLLLLLLLLLLLLLgggggggvvvvvvvvvvvggggAaa
aaAgggggggggggLLLLLLLLLLLLLLLLLLLLLLLLLLLLggggggggvvvvvvvvvvvvvvvggggvvvvvvvvvvvvvggggvvvvvvvvvvggLLLLLLLLLLLLLLLLLLLLLLLLLLLgggggggvvvvvvvvvvvggggAaa
aaAgggggggggggLLLLLLLLLLLLLLLLLLLLLLLLLLLLggggggggvvvvvvvvvvvvvvvggggvvvvvvvvvvvvvggggvvvvvvvvvvggLLLLLLLLLLLLLLLLLLLLLLLLLLLgggggggvvvvvvvvvvvggggAaa
aaAgggggggggggLLLLLLLLLLLLLLLLLLLLLLLLLLLLggggggggvvvvvvvvvvvvvvvggvvvvvvvvvvvvvvvvvggvvvvvvvvvvggLLLLLLLLLLLLLLLLLLLLLLLLLLLgggggggvvvvvvvvvvvggggAaa
aaAgggggggggggLLLLLLLLLLLLLLLLLLLLLLLLLLLLggggggggvvvvvvvvvvvvvvvggvvvvvvvvvvvvvvvvvggvvvvvvvvvvggLLLLLLLLLLLLLLLLLLLLLLLLLLLgggggggvvvvvvvvvvvggggAaa
aaAgggggggggggLLLLLLLLLLLLLLLLLLLLLLLLLLLLggggggggvvvvvvvvvvvvvvvggvvvvvvvvvvvvvvvvvggvvvvvvvvvvggLLLLLLLLLLLLLLLLLLLLLLLLLLLgggggggvvvvvvvvvvvggggAaa
aaAgggggggggggLLLLLLLLLLLLLLLLLLLLLLLLLLLLggggggggvvvvvvvvvvvvvvvggvvvvvvvvvvvvvvvvvggggggggggggggggggggggggggLLLgggggggggggggggggggvvvvvvvvvvvggggAaa
aaAgggggggggggLLLLLLLLLLLLLLLLLLLLLLLLLLLLgggggggggggggggggggggggggvvvvvvvvvvvvvvvvvggggggggggggggggggggggggggggggggggggggggggggggggvvvvvvvvvvvggggAaa
aaAgggggggggggLLLLLLLLLLLLLLLLLLLLLLLLLLLLgggggggggggggggggggggggggvvvvvvvvvvvvvvvvvggggggggggggggggggggggggggggggggggggggggggggggggvvvvvvvvvvvggggAaa
aaAgggggggggggLLLLLLLLLLLLLLLLLLLLLLLLLLLLgggggggggggggggggggggggggvvvvvvvvvvvvvvvvvggggggggggggggggggggggggggggggggggggggggggggggggvvvvvvvvvvvggggAaa
aaAgggggggggggLLLLLLLLLLLLLLLLLLLLLLLLLLLLgggggggggggggggggggggggggvvvvvvvvvvvvvvvvvggggggggggggggggggggggggggggggggggggggggggggggggvvvvvvvvvvvggggAaa
aaAgggggggggggLLLLLLLLLLLLLLLLLLLLLLLLLLLLgggggggggggggggggggggggggvvvvvvvvvvvvvvvvvggggggggggggggggggggggggggggggggggggggggggggggggvvvvvvvvvvvggggAaa
aaAgggggggggggLLLLLLLLLLLLLLLLLLLLLLLLLLLLgggggggggggggggggggggggggvvvvvvvvvvvvvvvvvgggggggggggggggggggggggggggggggggggggggggggggggggggggggggggggggAaa
aaAgggggggggggLLLLLLLLLLLLLLLLLLLLLLLLLLLLgggggggggggggggggggggggggvvvvvvvvvvvvvvvvvgggggggggggggggggLLLggggggLLLggggggLLLgggggggggggggggggggggggggAaa
aaAgggggggggggLLLLLLLLLLLLLLLLLLLLLLLLLLLLgggggggggggggggggggggggggvvvvvvvvvvvvvvvvvgggggggggggggggggLLLLLLLLLLLLLLLLLLLLLLLgggggggggggggggggggggggAaa
aaAgggggggggggLLLLLLLLLLLLLLLLLLLLLLLLLLLLgggggggggggggggggggggggggvvvvvvvvvvvvvvvvvgggggggggggggggggLLLLLLLLLLLLLLLLLLLLLLLgggggggggggggggggggggggAaa
aaAgggggggggggLLLLLLLLLLLLLLLLLLLLLLLLLLLLgggggggggggggggggggggggggvvvvvvvvvvvvvvvvvgggggggggggggggggLLLLLLLLLLLLLLLLLLLLLLLgggggggggggggggggggggggAaa
aaAgggggggggggLLLLLLLLLLLLLLLLLLLLLLLLLLLLgggggggggggggggggggggggggggggggggggggggggggggggggggggggggggLLLLLLLLLLLLLLLLLLLLLLLgggggggggggggggggggggggAaa
aaAgggggggggggLLLLLLLLLLLLLLLLLLLLLLLLLLLLggggggggggggggggggggggggggggggggggggggggggggggggggggggggLLLLLLLLLLLLLLLLLLLLLLLLLLLggggggggggggggggggggggAaa
aaAgggggggggggLLLLLLLLLLLLLLLLLLLLLLLLLLLLgggggggggggggggggvvvvvvvvvgggvvvvvvvvvgggvvvvvvvvvvgggggLLLLLLLLLLLLLLLLLLLLLLLLLLLggggggggggggggggggggggAaa
aaAgggggggggggLLLLLLLLLLLLLLLLLLLLLLLLLLLLgggggggggggggggggvvvvvvvvvgggvvvvvvvvvgggvvvvvvvvvvgggggLLLLLLLLLLLLLLLLLLLLLLLLLLLggggggggggggggggggggggAaa
aaAgggggggggggLLLLLLLLLLLLLLLLLLLLLLLLLLLLgggggggggggggggggvvvvvvvvvgggvvvvvvvvvgggvvvvvvvvvvgggggLLLLLLLLLLLLLLLLLLLLLLLLLLLggggggggggggggggggggggAaa
aaAgggggggggggLLLLLLLLLLLLLLLLLLLLLLLLLLLLgggggggggggggggggvvvvvvvvvgggvvvvvvvvvgggvvvvvvvvvvgggggLLLLLLLLLLLLLLLLLLLLLLLLLLLggggggggggggggggggggggAaa
aaAgggggggggggLLLLLLLLLLLLLLLLLLLLLLLLLLLLgggggggggggggggggvvvvvvvvvgggvvvvvvvvvgggvvvvvvvvvvgggggLLLLLLLLLLLLLLLLLLLLLLLLLLLggggggggggggggggggggggAaa
aaAgggggggggggLLLLLLLLLLLLLLLLLLLLLLLLLLLLgggggggggggggggggvvvvvvvvvgggvvvvvvvvvgggvvvvvvvvvvgggggLLLLLLLLLLLLLLLLLLLLLLLLLLLggggggggggggggggggggggAaa
aaAgggggggggggLLLLLLLLLLLLLLLLLLLLLLLLLLLLgggggggggggggggggggggggggggggggggggggggggvvvvvvvvvvgggggLLLLLLLLLLLLLLLLLLLLLLLLLLLggggggggggggggggggggggAaa
aaAgggggggggggLLLLLLLLLLLLLLLLLLLLLLLLLLLLgggggggggggggggggggggggggggggggggggggggggvvvvvvvvvvgggggLLLLLLLLLLLLLLLLLLLLLLLLLLLggggggggggggggggggggggAaa
aaAggggggggggggggggggggggggggggggggggggggggggggggggggggggggggggggggggggggggggggggggvvvvvvvvvvgggggLLLLLLLLLLLLLLLLLLLLLLLLLLLggggggggggvvvvvgggggggAaa
aaAggggggggggggggggggggggggggggggggggggggggggggggggggggggggggggggggggggggggggggggggvvvvvvvvvvgggggLLLLLLLLLLLLLLggggCgggggggggggggggggvvvvvvvggggggAaa
aaAggggggggggggggggggggggggggggggggggggggggggggggggggggggggggggggggggggggggggggggggvvvvvvvvvvgggggLLLLLLLLLLLLLLggggggggggggggggggggggvvvvvvvggggggAaa
aaAggggggggggggggggggjjjjjjjjjjjjjjjjjjjjjjjjjjjjjjjjjjjjjjjjjjjjjjjjjjjjjjjjjjjjjjjjjjjjjjjjjjjjjjjjjjjjjjjjjjjjjjjjjjjjjjjjgggggggggvvvvvvvggggggAaa
aaAggggggggggggggggggjJJJJJJJJJJJWWWWWWWWWWWWWWWWWWWWWWWWWWWWWWWWWWWWWWWWWWWWWWWWWWWWWWWWWWWWWWWWWWWWWWWWWWWWWWWWJJJJJJJJJJJjggggggggvvvvvvvvvgggggAaa
aaAggggggggggggggggggjJJJJJJJJJJJWWWWWWWWWWWWWWWWWWWWWWWWWWWWWWWWWWWWWWWWWWWWWWWWWWWWWWWWWWWWWWWWWWWWWWWWWWWWWWWWJJJJJJJJJJJjggggggvvvvvvvvvvvvvgggAaa
aaAggggggggggggggggggjJJJJJJJJJJJWWWWWWWWWWWWWWWWWWWWWWWWWWWWWWWWWWWWWWWWWWWWWWWWWWWWWWWWWWWWWWWWWWWWWWWWWWWWWWWWJJJJJJJJJJJjggggggvvvvvvvvvvvvvgggAaa
aaAggggggggggggggggggjJJJJJJJJJJJWWWWWWWWWWWWWWWWWWWWWWWWWWWWWWWWWWWWWWWWWWWWWWWWWWWWWWWWWWWWWWWWWWWWWWWWWWWWWWWWJJJJJJJJJJJjggggggvvvvvvvvvvvvvgggAaa
aaAggggggggggggggggggjJJJJJJJJJJJWWWWWWWWWWWWWWWWWWWWWWWWWWWWWWWWWWWWWWWWWWWWWWWWWWWWWWWWWWWWWWWWWWWWWWWWWWWWWWWWJJJJJJJJJJJjggggggvvvvvvvvvvvvvgggAaa
aaAggggggggggggggggggjOOJJJJJJJJJWWWWWWWWWWWWWWWWWWWWWWWWWWWWWWWWWWWWWWWWWWWWWWWWWWWWWWWWWWWWWWWWWWWWWWWWWWWWWWWWJJJJJJJJJOOjggggggvvvvvvvvvvvvvgggAaa
aaAggggggggggggggggggjOOJJJJJJJJJWWWWWWWWWWWWWWWWWWWWWWWWWWWWWWWWWWWWWWWWWWWWWWWWWWWWWWWWWWWWWWWWWWWWWWWWWWWWWWWWJJJJJJJJJOOjggggggvvvvvvvvvvvvvgggAaa
aaAgggggvvvvvvvvvvvvgjOOJJJJJJJJJWWWWWWWWWWWWWWWWWWWWWWWWWWWWWWWWWWWWWWWWWWWWWWWWWWWWWWWWWWWWWWWWWWWWWWWWWWWWWWWWJJJJJJJJJOOjggggggvvvvvvvvvvvvvgggAaa
aaAgggggvvvvvvvvvvvvgjJJJJJJJJJJJWWWWWWWWWWWWWWWWWWWWWWWWWWWWWWWWWWWWWWWWWWWWWWWWWWWWWWWWWWWWWWWWWWWWWWWWWWWWWWWWJJJJJJJJJJJjggggggvvvvvvvvvvvvvgggAaa
aaAgggggvvvvvvvvvvvvgjJJJJJJJJJJjjjjjjjjjjjjjjjjjjjjjjjjjjjjjjjjjjjjjjjjjjjjjjjjjjjjjjjjjjjjjjjjjjjjjjjjjjjjjjjjjJJJJJJJJJJJjggggggvvvvvvvvvvvvvgggAaa
aaAgggggvvvvvvvvvvvvgjWWWWWWWWWWjgggggggggggggggggggggggggvvvvvvvvggggggggggLLLLLLLLLLLLLLLLLLLLLgggggggggggggggjWWWWWWWWWWWjggggggvvvvvvvvvvvvvgggAaa
aaAgggggvvvvvvvvvvvvgjWWWWWWWWWWjgggggggggggggggggggggggggggggggggggggggggggLLLLLLLLLLLLLLLLLLLLLgggggggggggggggjWWWWWWWWWWWjggggggvvvvvvvvvvvvvgggAaa
aaAgggggvvvvvvvvvvvvgjWWWWWWWWWWjgggggggggggggggggggggggggggggggggggggggggggLLLLLLLLLLLLLLLLLLLLLgggggggggggggggjWWWWWWWWWWWjggggggvvvvvvvvvvvvvgggAaa
aaAgggggvvvvvvvvvvvvgjWWWWWWWWWWjgggggggggggggggggggggggggggggggggggggggggggLLLLLLLLLLLLLLLLLLLLLgggggggggggggggjWWWWWWWWWWWjgggggggvvvvvvvvvvvggggAaa
aaAgggggvvvvvvvvvvvvgjWWWWWWWWWWjgggggggggggggggggggggggggggggggggggggggggggLLLLLLLLLLLLLLLLLLLLLgggggggggggggggjWWWWWWWWWWWjgggggggvvvvvvvvvvvggggAaa
aaAgggggvvvvvvvvvvvvgjWWWWWWWWWWjgggggggggggggggggggggggggggggggggggggggggggLLLLLLLLLLLLLLLLLLLLLgggggggggggggggjWWWWWWWWWWWjgggggggvvvvvvvvvvvggggAaa
aaAgggggvvvvvvvvvvvvgjWWWWWWWWWWjgggggggggggggggggggggggggggggggggggggggggggLLLLLLLLLLLLLLLLLLLLLgggggggggggggggjWWWWWWWWWWWjggggggggvvvvvvvvvgggggAaa
aaAggggggggggggggggggjWWWWWWWWWWjgggggggggggggggggggggggggggggggggggggggggggLLLLLLLLLLLLLLLLLLLLLgggggggggggggggjWWWWWWWWWWWjggggggggggggggggggggggAaa
aaAgggggLLLLLLLLLLgggjWWWWWWWWWWjLcccccccccccccccgggggggggggggggggggggggggggLLLLLLLLLLLLLLLLLLLLLgggggggggggggggjWWWWWWWWWWWjggggggggggggggggggggggAaa
aaAgggggLLLLLLLLLLgggjWWWWWWWWWWjLczFNNNcNNNNNNNcgggggggggggggggggggggggggggLLLLLLLLLLLLLLLLLLLLLgggggggggggggggjWWWWWWWWWWWjggggggggggggggggggggggAaa
aaAgggggLLLLLLLLLLLLLjWWWWWWWWWWjLczzNNNcNNNNNNNcgggggggggggggggggggggggggggLLLLLLLLLLLLLLLLLLLLLgggggggggggggggjWWWWWWWWWWWjggggggggggggggggggggggAaa
aaAgggggLLLLLLLLLLLLLjWWWWWWWWWWjLcIzNNNcNNNNNNNcgggggggggggggggvvvvvvvvvvggLLLLLLLLLLLLLLLLLLLLLgggggggggggggggjWWWWWWWWWWWjggggggggggggggggggggggAaa
aaAgggggLLLLLLLLLLLLLjWWWWWWWWWWjLcNNNNNcNNNNNNNcgggggggggggggggvvvvvvvvvvggggggggggggggggggggggggggggggggggggggjWWWWWWWWWWWjggggggggggggggggggggggAaa
aaAgggggLLLLLLLLLLLLLjWWWWWWWWWWjLcccNcccNNNNNNNcgggggggggggggggvvvvvvvvvvggggggggggggggggggggggggggggggggggggggjWWWWWWWWWWWjggggggggggggggggggggggAaa
aaAgggggLLLLLLLLLLLLLjWWWWWWWWWWjLcNNNNNcNNNNNNNcgggggggggggggggvvvvvvvvvvggggggggggggggggggggggggggggggggggggggjWWWWWWWWWWWjggggggggggggggggggggggAaa
aaAgggggLLLLLLLLLLLLLjWWWWWWWWWWjLcNNNNNcNNNNNNNcgggggggggggggggvvvvvvvvvvggggggggggggggggggggggggggggggggggggggjWWWWWWWWWWWjggggggggggggggggggggggAaa
aaAgggggLLLLLLLLLLLLLjWWWWWWWWWWjLcNNNNNcNNNNNNNcgggggggggggggggvvvvvvvvvvggggggggggggggggggggggggggggggggggggggjWWWWWWWWWWWjggggggggggggggggggggggAaa
aaAgggggLLLLLLLLLLLLLjWWWWWWWWWWjLcNNNNNNNNNNNNNcgggggggggggggggvvvvvvvvvvggggggggggggggggggggggggggggggggggggggjWWWWWWWWWWWjggggggggggggggggggggggAaa
aaAgggggLLLLLLLLLLLLLjWWWWWWWWWWjLcNNNNNNNNNNNNNcgggggggggggggggvvvvvvvvvvggggggggggggggggggggggggggggggggggggggjWWWWWWWWWWWjggggggggggggggggggggggAaa
aaAgggggLLLLLLLLLLLLLjWWWWWWWWWWjLcEENNNcNNNNNNNcgggggggggggggggvvvvvvvvvvggLLLLLLLLLLLLLLLLgggvvvvvvvvvggggggggjWWWWWWWWWWWjggggggggggggggggggggggAaa
aaAgggggLLLLLLLLLLLLLjWWWWWWWWWWjLcEENNNcNNNNNNNcgggggggggggggggggggggggggggLLLLLLLLLLLLLLLLgggvvvvvvvvvggggggggjWWWWWWWWWWWjggggggggggggggggggggggAaa
aaAgggggLLLLLLLLLLgggjWWWWWWWWWWjLcNNNNNcNNNNNNNcgggggggggggggggggggggggggggLLLLLLLLLLLLLLLLgggvvvvvvvvvggggggggjWWWWWWWWWWWjggggggggggggggggggggggAaa
aaAgggggLLLLLLLLLLgggjWWWWWWWWWWjLcccccccccccccccgggggggHHHHHHHHgggHHHHHHHggLLLLLLLLLLLLLLLLgggvvvvvvvvvggggggggjWWWWWWWWWWWjggggggggggggggggggggggAaa
aaAggggggggggggggggggjWWWWWWWWWWjgggggggggggggggggggggggHHHHHHHHgggHHHHHHHggLLLLLLLLLLLLLLLLgggvvvvvvvvvggggggggjWWWWWWWWWWWjggggggggggggggggggggggAaa
aaAggggggggggggggggggjWWWWWWWWWWjgggggggggggggggggggggggHHHHHHHHgggHHHHHHHggLLLLLLLLLLLLLLLLgggvvvvvvvvvggggggggjWWWWWWWWWWWjggggggggggggggggggggggAaa
aaAggggggggggggggggggjWWWWWWWWWWjgggggggggggggggggggggggHHHHHHHHgggHHHHHHHggLLLLLLLLLLLLLLLLgggvvvvvvvvvggggggggjWWWWWWWWWWWjggggggggggggggggggggggAaa
aaAggggggggggggggggggjJJJJJJJJJJjjjjjjjjjjjjjjjjjjjjjjjjjjjjjjjjjjjjjjjjjjjjjjjjjjjjjjjjjjjjjjjjjjjjjjjjjjjjjjjjjJJJJJJJJJJJjggggggggggggggggggggggAaa
aaAggggggggggggggggggjJJJJJJJJJJJWWWWWWWWWWWWWWWWWWWWWWWWWWWWWWWWWWWWWWWWWWWWWWWWWWWWWWWWWWWWWWWWWWWWWWWWWWWWWWWWJJJJJJJJJJJjggggggggggggggggggggggAaa
aaAggggggggggggggggggjJJJJJJJJJJJWWWWWWWWWWWWWWWWWWWWWWWWWWWWWWWWWWWWWWWWWWWWWWWWWWWWWWWWWWWWWWWWWWWWWWWWWWWWWWWWJJJJJJJJJJJjggggggggggggggggggggggAaa
aaAggggggggggggggggggjJJJJJJJJJJJWWWWWWWWWWWWWWWWWWWWWWWWWWWWWWWWWWWWWWWWWWWWWWWWWWWWWWWWWWWWWWWWWWWWWWWWWWWWWWWWJJJJJJJJJJJjggggggggggggggggggggggAaa
aaAggggggggggggggggggjJJJJJJJJJJJWWWWWWWWWWWWWWWWWWWWWWWWWWWWWWWWWWWWWWWWWWWWWWWWWWWWWWWWWWWWWWWWWWWWWWWWWWWWWWWWJJJJJJJJJJJjggggggggggggggggggggggAaa
aaAggggggggggggggggggjJJJJJJJJJJJWWWWWWWWWWWWWWWWWWWWWWWWWWWWWWWWWWWWWWWWWWWWWWWWWWWWWWWWWWWWWWWWWWWWWWWWWWWWWWWWJJJJJJJJJJJjggggggggggggggggggggggAaa
aaAggggggggggggggggggjJJJJJJJJJJJWWWWWWWWWWWWWWWWWWWWWWWWWWWWWWWWWWWWWWWWWWWWWWWWWWWWWWWWWWWWWWWWWWWWWWWWWWWWWWWWJJJJJJJJJJJjggggggggggggggggggggggAaa
aaAggggggggggggggggggjJJJJJJJJJJJWWWWWWWWWWWWWWWWWWWWWWWWWWWWWWWWWWWWWWWWWWWWWWWWWWWWWWWWWWWWWWWWWWWWWWWWWWWWWWWWJJJJJJJJJJJjggggggggggggggggggggggAaa
aaAggggggggggggggggggjJJJJJJJJJJJWWWWWWWWWWWWWWWWWWWWWWWWWWWWWWWWWWWWWWWWWWWWWWWWWWWWWWWWWWWWWWWWWWWWWWWWWWWWWWWWJJJJJJJJJJJjggggggggggggggggggggggAaa
aaAggggggggggggggggggjJJJJJJJJJJJWWWWWWWWWWWWWWWWWWWWWWWWWWWWWWWWWWWWWWWWWWWWWWWWWWWWWWWWWWWWWWWWWWWWWWWWWWWWWWWWJJJJJJJJJJJjggggggggggggggggggggggAaa
aaAggggggggggggggggggjjjjjjjjjjjjjjjjjjjjjjjjjjjjjjjjjjjjjjjjjjjjjjjjjjjjjjjjjjjjjjjjjjjjjjjjjjjjjjjjjjjjjjjjjjjjjjjjjjjjjjjjggggggggggggggggggggggAaa
aaAgggggggggggggggggggggggggggggggggggggggggggggggggggggBBBBBBgggggggggggggggggggggggggggggggggggggggggggggggggggggggggggggggggggggggggggggggggggggAaa
aaAggggggggggggggggggggggggggggggggggggggggggggggggggggggggggggggggggggggggggggggggggggggggggggggggggggggggggggggggggggggggggggggggggggggggggggggggAaa
aaAgggggggggggggggggggggggggggggggggggggggggggggggggggggBBBBBBgggggggggggggggggggggggggggggggggggggggggggggggggggggggggggggggggggggggggggggggggggggAaa
aaAgggggggggggggggggggggggggggggggggggggggggggggggggggggBBBBBBgggggggggggggggggggggggggggggggggggggggggggggggggggggggggggggggggggggggggggggggggggggAaa
aaAgggggggggggggggggggggggggggggggggggggggggggggggggggggBBBBBBgggggggggggggggggggggggggggggggggggggggggggggggggggggggggggggggggggggggggggggggggggggAaa
aaAgggggggggggggggggggggggggggggggggggggggggggggggggggggBBBBBBgggggggggggggggggggggggggggggggggggggggggggggggggggggggggggggggggggggggggggggggggggggAaa
aaAgggggggggggggggggggggggggggggggggggggggggggggggggggggBBBBBBgggggggggggggggggggggggggggggggggggggggggggggggggggggggggggggggggggggggggggggggggggggAaa
aaAggggggggggggggggggggggggggggggggggggggggggggggggggggggggggggggggggggggggggggggggggggggggggggggggggggLLLLLLLLLLLLLLLLLLLLLLLLLLLLLLLLLLLLLLLLLLLgAaa
aaAgggggggggggggggggggrrrrrrrrrrrrrrrrrrrgggggggggggggggBBBBBBggggggggggggggggggggggggggggggggggggggggLLLLLLLLLLLLLLLLLLLLLLLLLLLLLLLLLLLLLLLLLLLLgAaa
aaAgggggggggggggggggggrrrrrrrrrrrrrrrrrrrgggggggggggggggBBBBBBgggggggggggggggggggggggggggggggggggggggLLLLLLLLLLLLLLLLLLLLLLLLLLLLLLLLLLLLLLLLLLLLLgAaa
aaAgggggggggggggggggggrrrrrrrrrrrrrrrrrrrgggggggggggggggBBBBBBggggggggggggggggggggggggLLLLLLLLLLLLLLLLLLLLLLLLLLLLLLLLLLLLLLLLLLLLLLLLLLLLLLLLLLLLgAaa
aaAgggggggggggggggggggrrrrrrrrrrrrrrrrrrrgggggggggggggggBBBBBBggggggggggggggggggggggggLLLLLLLLLLLLLLLLLLLLLLLLLLLLLLLLLLLLLLLLLLLLLLLLLLLLLLLLLLLLgAaa
aaAgggggggggggggggggggrrrrrrrrrrrrrrrrrrrgggggggggggggggBBBBBBggggggggggggggggggggggggLLLLLLLLLLLLLLLLLLLLLLLLLLLLLLLLLLLLLLLLLLLLLLLLLLLLLLLLLLLLgAaa
aaAgggggggggggggggggggrrrrrrrrrrrrrrrrrrrgggggggggggggggggggggggLLLLLLLLLLggggggggggggLLLLLLLLLLLLLLLLLLLLLLLLLLLLLLLLLLLLLLLLLLLLLLLLLLLLLLLLLLLLgAaa
aaAgggggggggggggggggggrrrrrrrrrrrrrrrrrrrgggggggggggggggggggggggLLLLLLLLLLggggggggggggLLLLLLLLLLLLLLLLLLLLLLLLLLLLLLLLLLLLLLLLLLLLLLLLLLLLLLLLLLLLgAaa
aaAgggggggggggggggggggrrrrrrrrrrrrrrrrrrrgggggggggggggggggggggggLLLLLLLLLLggggggggggggLLLLLLLLLLLLLLLLLLLLLLLLLLLLLLLLLLLLLLLLLLLLLLLLLLLLLLLLLLLLgAaa
aaAgggggggggggggggggggrrrrrrrrrrrrrrrrrrrgggggggggggggggggggggggLLLLLLLLLLggggggggggggLLLLLLLLLLLLLLLLLLLLLLLLLLLLLLLLLLLLLLLLLLLLLLLLLLLLLLLLLLLLgAaa
aaAgggggggggggggggggggrrrrrrrrrrrrrrrrrrrgggggggggggggggggggggggLLLLLLLLLLggggggggggggLLLLLLLLLLLLLLLLLLLLLLLLLLLLLLLLLLLLLLLLLLLLLLLLLLLLLLLLLLLLgAaa
aaAgggggggggggggggggggrrrrrrrrrrrrrrrrrrrgggggggggggggggggggggggLLLLLLLLLLggggggggggggLLLLLLLLLLLLLLLLLLLLLLLLLLLLLLLLLLLLLLLLLLLLLLLLLLLLLLLLLLLLgAaa
aaAgggggggggggggggggggrrrrrrrrrrrrrrrrrrrgggggggggggggggggggggggLLLLLLLLLLggggggggggggLLLLLLLLLLLLLLLLLLLLLLLLLLLLLLLLLLLLLLLLLLLLLLLLLLLLLLLLLLLLgAaa
aaAgggggggggggggggggggrrrrrrrrrrrrrrrrrrrgggggggggggggggggggggggLLLLLLLLLLggggggggggggLLLLLLLLLLLLLLLLLLLLLLLLLLLLLLLLLLLLLLLLLLLLLLLLLLLLLLLLLLLLgAaa
aaAgggggggggggggggggggggggggggggggggggggggggggggggggggggggggggggLLLLLLLLLLggggggggggggLLLLLLLLLLLLLLLLLLLLLLLLLLLLLLLLLLLLLLLLLLLLLLLLLLLLLLLLLLLLgAaa
aaAggggggggggggggggggggggggggggggHHHHHHHHgggggggggggggggggggggggLLLLLLLLLLggggggggggggLLLLLLLLLLLLLLLLLLLLLLLLLLLLLLLLLLLLLLLLLLLLLLLLLLLLLLLLLLLLgAaa
aaAggggggggggggggggggggggggggggggHHHHHHHHgggggggggggggggggggggggLLLLLLLLLLggggggggggggLLLLLLLLLLLLLLLLLLLLLLLLLLLLLLLLLLLLLLLLLLLLLLLLLLLLLLLLLLLLgAaa
aaAggggggggggggggggggggggggggggggHHHHHHHHgggggggggggggggggggggggggggggggggggggggggggggLLLLLLLLLLLLLLLLLLLLLLLLLLLLLLLLLLLLLLLLLLLLLLLLLLLLLLLLLLLLgAaa
aaAggggggggggggggggggggggggggggggHHHHHHHHgggggggggggggggggggggggggggggggggggggggggggggLLLLLLLLLLLLLLLLLLLLLLLLLLLLLLLLLLLLLLLLLLLLLLLLLLLLLLLLLLLLgAaa
aaAggggggggggggggggggggggggggggggHHHHHHHHHHHHHHgggggggggggggggggggggggggggggggggggggggLLLLLLLLLLLLLLLLLLLLLLLLLLLLLLLLLLLLLLLLLLLLLLLLLLLLLLLLLLLLgAaa
aaAggggggggggggggggggggggggggggggHHHHHHHHHHHHHHggLLLLLLLLLggggggLLLLLLLLLgggggggggggggLLLLLLLLLLLLLLLLLLLLLLLLLLLLLLLLLLLLLLLLLLLLLLLLLLLLLLLLLLLLgAaa
aaAggggggggggggggggggggggggggggggHHHHHHHHHHHHHHggLLLLLLLLLggggggLLLLLLLLLgggggggggggggLLLLLLLLLLLLLLLLLLLLLLLLLLLLLLLLLLLLLLLLLLLLLLLLLLLLLLLLLLLLgAaa
aaAggggggggggggggggggggggggggggggHHHHHHHHHHHHHHggLLLLLLLLLggggggLLLLLLLLLgggggggggggggLLLLLLLLLLLLLLLLLLLLLLLLLLLLLLLLLLLLLLLLLLLLLLLLLLLLLLLLLLLLgAaa
aaAggggggggggggggggggggggggggggggHHHHHHHHHHHHHHggLLLLLLLLLggggggLLLLLLLLLgggggggggggggLLLLLLLLLLLLLLLLLLLLLLLLLLLLLLLLLLLLLLLLLLLLLLLLLLLLLLLLLLLLgAaa
aaAggggggggggggggggggggggggggggggHHHHHHHHHHHHHHggLLLLLLLLLggggggLLLLLLLLLgggggggggggggLLLLLLLLLLLLLLLLLLLLLLLLLLLLLLLLLLLLLLLLLLLLLLLLLLLLLLLLLLLLgAaa
aaAggggggggggggggggggggggggggggggggggggggggggggggLLLLLLLLLggggggLLLLLLLLLgggggggggggggLLLLLLLLLLLLLLLLLLLLLLLLLLLLLLLLLLLLLLLLLLLLLLLLLLLLLLLLLLLLgAaa
aaAggggggggggggggggggggggggggggggggggggggggggggggLLLLLLLLLggggggLLLLLLLLLgggggggggggggLLLLLLLLLLLLLLLLLLLLLLLLLLLLLLLLLLLLLLLLLLLLLLLLLLLLLLLLLLLLgAaa
aaAggggggggggggggggggggggggggggggggggggggggggggggLLLLLLLLLggggggLLLLLLLLLgggggggggggggLLLLLLLLLLLLLLLLLLLLLLLLLLLLLLLLLLLLLLLLLLLLLLLLLLLLLLLLLLLLgAaa
aaAggggggggggggggggggggggggggggggggggggggggggggggLLLLLLLLLggggggLLLLLLLLLgggggggggggggLLLLLLLLLLLLLLLLLLLLLLLLLLLLLLLLLLLLLLLLLLLLLLLLLLLLLLLLLLLLgAaa
aaAggggggggggggggggggggggggggggggggggggggggggggggLLLLLLLLLggggggLLLLLLLLLgggggggggggggLLLLLLLLLLLLLLLLLLLLLLLLLLLLLLLLLLLLLLLLLLLLLLLLLLLLLLLLLLLLgAaa
aaAgggggggggggggggggggggggggggggggggggggggggggggggggggggggggggggggggggggggggggggggggggLLLLLLLLLLLLLLLLLLLLLLLLLLLLLLLLLLLLLLLLLLLLLLLLLLLLLLLLLLLLgAaa
aaAgggggggggggggggggggggggggggggggggggggggggggggggggggggggggggggggggggggggggggggggggggLLLLLLLLLLLLLLLLLLLLLLLLLLLLLLLLLLLLLLLLLLLLLLLLLLLLLLLLLLLLgAaa
aaAgggggggggggggggggggggggggggggggggggggggggggggggggggggggggggggggggggggggggggggggggggLLLLLLLLLLLLLLLLLLLLLLLLLLLLLLLLLLLLLLLLLLLLLLLLLLLLLLLLLLLLgAaa
aaAgggggggggggggggggggggggggggggggggggggggggggggggggggggggggggggggggggggggggggggggggggLLLLLLLLLLLLLLLLLLLLLLLLLLLLLLLLLLLLLLLLLLLLLLLLLLLLLLLLLLLLgAaa
aaAgggggggggggggggggggggggggggggggggggggggggggggggggggggggggggggggggggggggggggggggggggLLLLLLLLLLLLLLLLLLLLLLLLLLLLLLLLLLLLLLLLLLLLLLLLLLLLLLLLLLLLgAaa
aaAggggggggggggggggggggggggggggggggggggggggggggggggggggggggggggggggggggggggggggggggggggggggggggggggggggggggggggggggggggggggggggggggggggggggggggggggAaa
aaAggggggggggggggggggggggggggggggggggggggggggggggggggggggggggggggggggggggggggggggggggggggggggggggggggggggggggggggggggggggggggggggggggggggggggggggggAaa
aaAggggggggggggggggggggggggggggggggggggggggggggggggggggggggggggggggggggggggggggggggggggggggggggggggggggggggggggggggggggggggggggggggggggggggggggggggAaa
aaAggggggggggggggggggggggggggggggggggggggggggggggggggggggggggggggggggggggggggggggggggggggggggggggggggggggggggggggggggggggggggggggggggggggggggggggggAaa
aaAggggggggggggggggggggggggggggggggggggggggggggggggggggggggggggggggggggggggggggggggggggggggggggggggggggggggggggggggggggggggggggggggggggggggggggggggAaa
aaAggggggggggggggggggggggggggggggggggggggggggggggggggggggggggggggggggggggggggggggggggggggggggggggggggggggggggggggggggggggggggggggggggggggggggggggggAaa
aaAAAAAAAAAAAAAAAAAAAAAAAAAAAAAAAAAAAAAAAAAAAAAAAAAAAAAAAAAAAAAAAAAAAAAAAAAAAAAAAAAAAAAAAAAAAAAAAAAAAAAAAAAAAAAAAAAAAAAAAAAAAAAAAAAAAAAAAAAAAAAAAAAAaa
aaaaaaaaaaaaaaaaaaaaaaaaaaaaaaaaaaaaaaaaaaaaaaaaaaaaaaaaaaaaaaaaaaaaaaaaaaaaaaaaaaaaaaaaaaaaaaaaaaaaaaaaaaaaaaaaaaaaaaaaaaaaaaaaaaaaaaaaaaaaaaaaaaaaaa
Gaaaaaaaaaaaaaaaaaaaaaaaaaaaaaaaaaaaaaaaaaaaaaaaaaaaaaaaaaaaaaaaaaaaaaaaaaaaaaaaaaaaaaaaaaaaaaaaaaaaaaaaaaaaaaaaaaaaaaaaaaaaaaaaaaaaaaaaaaaaaaaaaaaaaa
"}
